00000000000000000000000000000000000000000000000000000000000000000000000000000000000000000000000000000000000000000000000000000000000000000000000000000000000000000000000000000000000000000000000000000000000000000000000000000000
00000000000000000001230000000000000012230000000000000000000000000001230000000000000012230000000000000000000000000001230000000000000012230000000000000000000000000001230000000000000012230000000000000040000000000001230000000000
00000000123000000005670000012223000056670000000000000000123000000005670000012223000056670000000000000000123000000005670000012223000056670000000000000000123000000005670000012223000056670000000000000080123000000005670000012223
00000000567000000000000000056667000000000000000000000000567000000000000000056667000000000000000000000000567000000000000000056667000000000000000000000000567000000000000000056667000000000000000000000080567000000000000000056667
00000000000000000000009000000000000000000000000000000000000000000000000000000000::::::::000:::900000000000000;00000000000:::0000:99:00000000000000000000000000000000000000000000000000000000<<0000000080000000000000000000000000
0000000000000000000000000000000000000000000000000000000000000000000000000000000000000000000000000000000000000000000000000000000000000000000000000000000000000000000000000000000000000000000<<<0000000080000000000000000000000000
000000000000000000000000000000000000000000000000000000000000000000000000000000000000000000000000000000000000000000000000000000000000000000000000000000000000000000000000000000000000000000<<<<0000000080000000000000000000000000
0000000000000000000000000000000000000000000000000000000000000000=000000000000000000000000000000000000000000000000000000000000000000000000000000000000000000000000000000000000000000000000<<<<<0000000080000>>>000000000000000000
00000000000000009000:;:9:000000000000000000000?@000000000?@000000000000000000:;:00000000000000A00000:B0000900900900000:0000000000::000000<00<0000000000<<00<000000000000::9:000000000000<<<<<<0000000080000CDE000000000000000000
00F00000000000000000000000000000000000?@000000GH00F000000GH000000000000000000000000000000000000000F0000000000000000000000000000000000000<<00<<0000F000<<<00<<00000000000000000000000000<<<<<<<0000F0008000>III>00000000000000000
0JKL0000000000000F0000000000?@00000000GH000000GH0JKL00000GH000000F0000000000000000000000000000000JKL0000000000000F000000000000000000000<<<00<<<00JKL0<<<<00<<<000F0?@00000000000000?@0<<<<<<<<000JKL008000DDMDD00F00000000000000
JKNOL000000PQQQRJKL0000PQR00GH00000000GH0PQQR0GHJKNOL0000GHPQQQRJKL0000PQR000000000000000PQQR000JKNOL000000PQQQRJKL0000PQR000000000000<<<<QQ<<<<JKNO<<<<<00<<<<RJKLGH00PQR000000000GH<<<<<<<<<00JKNOL0<000DDSDDRJKL0000PQR000000
TTTTTTTTTTTTTTTTTTTTTTTTTTTTTTTTTTTTTTTTTTTTTTTTTTTTTTTTTTTTTTTTTTTTT00TTTTTTTTTTTTTTT000TTTTTTTTTTTTTTTTTTTTTTTTTTTTTTTTTTTTTTTTTTTTTTTTTTTTTTTTTTTTTTTT00TTTTTTTTTTTTTTTTTTTTTTTTTTTTTTTTTTTTTTTTTTTTTTTTTTTTTTTTTTTTTTTTTTTTT
TTTTTTTTTTTTTTTTTTTTTTTTTTTTTTTTTTTTTTTTTTTTTTTTTTTTTTTTTTTTTTTTTTTTT00TTTTTTTTTTTTTTT000TTTTTTTTTTTTTTTTTTTTTTTTTTTTTTTTTTTTTTTTTTTTTTTTTTTTTTTTTTTTTTTT00TTTTTTTTTTTTTTTTTTTTTTTTTTTTTTTTTTTTTTTTTTTTTTTTTTTTTTTTTTTTTTTTTTTTT
