000000000000000000000000000000000000000000000000000000000000000000000000000000000000000000000000000000000000000000000000000000000000000000000000000000000000000000000000000000000000000000000000
100000111111111111111111111111111111111111111111111111111111111111111111111111111111111112111111111111111111111111111111111111111111111111000000000000000000000001111111341111111111111111100011
100000000000000000000000000000000000000000000000000000110011111100111100000011110000000000000000000000000000000000000000000000000000000000000000000000000000000000000000341111111000000000000011
100000000000000000000000000000000000000000000000000000110011111100111100000011110000000000000000000000000000000000000000000000000000000000000000000000000000005000000000341111111000000000000011
100000000000000000000000000000000000000006666000000011000000001100010000110000000000666666000000000000000000000000000000000000000000000000000000000000000000000000000000341111111000000000000011
100000000000000000000000000000000000000000000000000011000000001100010000110000000000000000000000000000000000000000000000000000000000000000000000000000000050000000000000341111111000000000000011
100000000000000000000000000000000000000101111070000011000000001100010000110000000000111111000000000000000000000000000000000000000000000000000000000000000000000000000000341111111000000000000011
1000000000000000000000000000080000000001610016100000110000666611000169001800000000001111110000000000000000000000000000000000000000000000000000000111119000000000000000:;<41111111000000000000011
1000000000=>>>>00000000?0?00000000000001110011100000111100111111000111001100111100000000000000000000000000000@A0000000000000000000000000??0000000000000000000000000000BCD41111111000000000000011
100000000000000000000?0?0?0?000?00000000000000000000001100000000000000000000000000000000000000000000000@A000034000000000001100000000000???0000000000000005000000111111111111111110@A00@A00@A0011
1000000000000000000?0?0?0?0?000?0?000000000000000000001100000000000000000000000000000000000000000000000340000340000@A00000110000000000????000000000000000000000011111111111111111034003400340011
10000000000000000?0?0?0?0?0?000?0?000000000000000000000000000000000000000000000000000000000000000000000340000340000340000011000000000?????000000000000000000000011111111111111111034003400340011
555555555555555555555555555555555555555555555555555555555555555555555555555555550005555555555555555555555555555555555555005500555555555555000000055555555000000055555555555555555555555555555555
555555555555555555555555555555555555555555555555555555555555555555555555555555550005555555555555555555555555555555555555005500555555555555000000055555555000000055555555555555555555555555555555
